1111111111
1        1
3  22    2
1  1     2
3        1
1231     3
1       11
3 1    111
1 2      3
1111333331